// This is a comment and gets igonred when reading.
// : - types are read with a space after ex. (Title: )
// <> - types are expected to contain integer values

Title: Pacman: Kinda
Theme: Summer
TileSize: 32

<tiles>
   0   0   0   0   0 250 250 250 250 250 250 250 250 250 250 250 250 250 250   0
   0   0   0   0 250 250 250 250 250 250 250 250 250 250 250 250 250 250 250
   0   0   0 250 250 250 250 250 250 250 250 250 250 250 250 250 250 250
   0   0 250 250 250 250 250 250 250 250 250 250 250 250 250 250 250
   0   0 250 250 250 250 250 250 250 250 250 250 250 250 250 250
   0 250 250 250 250 250 250 250 250 250 250 250 250 250 250
   0 250 250 250 250 250 250 250 250 250 250 250 250 250
   0 250 250 250 250 250 250 250 250 250 250 250 250
 250 250 250 250 250 250 250 250 250 250 250 250
 250 250 250 250 250 250 250 250 250 250 250
 250 250 250 250 250 250 250 250 250 250
 250 250 250 250 250 250 250 250 250 250
 250 250 250 250 250 250 250 250 250 250 250
 250 250 250 250 250 250 250 250 250 250 250 250
   0 250 250 250 250 250 250 250 250 250 250 250 250
   0 250 250 250 250 250 250 250 250 250 250 250 250 250
   0 250 250 250 250 250 250 250 250 250 250 250 250 250 250
   0   0 250 250 250 250 250 250 250 250 250 250 250 250 250 250
   0   0 250 250 250 250 250 250 250 250 250 250 250 250 250 250 250
   0   0   0 250 250 250 250 250 250 250 250 250 250 250 250 250 250 250
   0   0   0   0 250 250 250 250 250 250 250 250 250 250 250 250 250 250 250
   0   0   0   0   0 250 250 250 250 250 250 250 250 250 250 250 250 250 250   0
</tiles>