Theme: Winter

<tiles> 
	31  32  33  34  35  36  37  38  39  40  41  42  43  44  45  46  47  48  49  50  51  52  53  54  55
	61  62  63  64  65  66  67  68  69  70  71  72  73  74  75  76  77  78  79  80  81  82  83  84  85
	91  92  93  94  95  96  97  98  99  100  101  102  103  104  105  106  107  108  109  110  111  112
	121  122  123  124  125  126  127  128  129  130  131  132  133  134  135  136  137  138  139  140
	151  152  153  154  155  156  157  158  159  160  161  162  163  164  165  166  167  168  169  170 	361  362  363  364  365  366  367  368  369  370  371  372  373  374  375  376  377  378  323  380
	181  182  183  184  185  186  187  188  189  190  191  192  193  194  195  196  197  198  199  200 	361  362  363  364  365  366  367  368  369  370  371  372  373  374  375  376  377  378  323  380
	211  212  213  214  215  216  217  218  219  220  221  222  223  224  225  226  227  228  229  230 	361  362  363  364  365  366  367  368  369  370  371  372  373  374  375  376  377  378  323  380
	241  242  243  244  245  246  247  248  249  250  251  252  253  254  255  256  257  258  259  260
	271  272  273  274  275  276  277  278  279  280  281  282  283  284  285  286  287  288  289  290
	301  302  303  304  305  306  307  308  309  310  311  312  313  314  315  316  317  318  319  320
	361  362  363  364  365  366  367  368  369  370  371  372  373  374  375  376  377  378  323  380
	361  362  363  364  365  366  367  368  369  370  371  372  373  374  375  376  377  378  323  380
	361  362  363  364  365  366  367  368  369  370  371  372  373  374  375  376  377  378  323  380
	361  362  363  364  365  366  367  368  369  370  371  372  373  374  375  376  377  378  323  380
	361  362  363  364  365  366  367  368  369  370  371  372  373  374  375  376  377  378  323  380
	361  362  363  364  365  366  367  368  369  370  371  372  373  374  375  376  377  378  323  380
	361  362  363  364  365  366  367  368  369  370  371  372  373  374  375  376  377  378  323  380
	361  362  363  364  365  366  367  368  369  370  371  372  373  374  375  376  377  378  323  380
	361  362  363  364  365  366  367  368  369  370  371  372  373  374  375  376  377  378  323  380
	361  362  363  364  365  366  367  368  369  370  371  372  373  374  375  376  377  378  323  380
	361  362  363  364  365  366  367  368  369  370  371  372  373  374  375  376  377  378  323  380
	361  362  363  364  365  366  367  368  369  370  371  372  373  374  375  376  377  378  323  380
	361  362  363  364  365  366  367  368  369  370  371  372  373  374  375  376  377  378  323  380
	361  362  363  364  365  366  367  368  369  370  371  372  373  374  375  376  377  378  323  380
</tiles>
		
<spawnpoint> 5, 2 
<spawnpoint> 3, 4 
<goldmine> 2, 2 